30
20
 2  8  8  8  8  8  8  8  8  8  8  8  8  8  8  8  8  8  8  8  8  8  8  8  8  8  8  8  8  3  
 6  0  1  1  1  1  1  1  1  1  1  1  1  1  1  1  1  1  1  1  1  1  1  1  1  1  1  1  1  7  
 6  1 14 24 16 16 16 13  1 14 16 16 16 16 16 16 16 16 16 16 13  1 14 16 16 16 24 13  1  7  
 6  1  1 15  1  1  1  1  1  1  1  1  1  1  1  1  1  1  1  1  1  1  1  1  1  1 15  1  1  7  
27 13  1 15  1 19 16 13  1 19 16 16 20  1 19 16 13  1 19 16 13  1 11  1 11  1 15  1 14 29  
 6  1  1 15  1 15  1  1  1 15  0  0 15  1 15  1  1  1 15  1  1  1 15  1 15  1 15  1  1  7  
 6  1 14 25  1 23 13  1  1 23 16 24 18  1 23 13  1  1 17 16 20  1 23 16 25  1 23 13  1  7  
 6  1  1 15  1 15  1  1  1 15  1 15  1  1 15  1  1  1  1  1 15  1 15  1 15  1 15  1  1  7  
27 13  1 12  1 12  1  1  1 12  1 12  1  1 17 16 13  1 14 16 18  1 12  1 12  1 12  1 14 29  
 6  1  1  1  1  1  1  1  1  1  1  1  1  1  1  1  1  1  1  1  1  1  1  1  1  1  1  1  1  7  
 6  1 19 16 16 16 20  1  1  1  1  1  1  1  1  1  1  1  1  1  1  1  1 19 16 16 16 20  1  7  
 6  1 15  1  1  1 15  1 19 16 24 16 20  1 19 16 20  1 19 16 16 20  1 15  1  1  1 15  1  7  
 6  1 15  1 11  1 15  1 15  1 15  1 15  1 15  0 15  1 15  1  1 15  1 15  1 11  1 15  1  7  
 6  1 12  1 15  1 15  1 15  1 15  1 15  1 23 16 25  1 15  1  1 15  1 15  1 15  1 12  1  7  
 6  1  1  1 15  1 15  1 15  1 12  1 15  1 15  1 15  1 15  1  1 15  1 15  1 15  1  1  1  7  
 6  1 11  1 15  1 15  1 12  1  1  1 12  1 12  1 12  1 12  1  1 12  1 15  1 15  1 11  1  7  
 6  1 15  1 15  1 15  1  1  1  1  1  1  1  1  1  1  1  1  1  1  1  1 15  1 15  1 15  1  7  
 6  1 12  1 15  1 17 16 13  1 14 16 16 16 16 16 16 16 16 16 13  1 14 18  1 15  1 12  1  7  
 6  1  1  1 15  1  1  1  1  1  1  1  1  1  1  1  1  1  1  1  1  1  1  1  1 15  1  1  0  7  
 4  9  9  9 26  9  9  9  9  9  9  9  9  9  9  9  9  9  9  9  9  9  9  9  9 26  9  9  9  5  
    