21 21
1 1 1 1 1 1 1 1 1 1 1 1 1 1 1 1 1 1 1 1 1
1 6 3 3 3 3 3 3 3 3 3 3 3 3 3 3 3 3 3 6 1
1 3 1 1 1 1 1 1 1 1 3 1 1 1 1 1 1 1 1 3 1
1 3 3 3 3 3 3 3 3 3 3 3 3 3 3 3 3 3 3 3 1
1 3 1 1 1 1 3 3 1 1 1 3 3 3 3 1 3 3 1 3 1
1 3 1 3 3 3 3 3 1 0 0 1 3 3 3 1 3 3 1 3 1
1 3 1 3 3 3 3 3 1 0 0 0 1 3 3 1 3 3 1 3 1
1 3 1 1 1 1 3 3 1 0 0 0 1 3 3 1 3 3 1 3 1
1 3 3 3 3 1 3 3 1 0 0 0 1 3 3 1 3 3 1 3 1
1 3 3 3 3 1 3 3 1 0 0 1 3 3 3 1 3 3 1 3 1
1 3 1 1 1 1 3 3 1 1 1 3 3 3 3 1 1 1 1 3 1
1 3 3 3 3 3 3 3 3 3 0 3 3 3 3 3 3 3 3 3 1
1 3 1 1 1 3 1 1 1 1 1 1 1 1 1 3 1 1 1 3 1
1 3 3 3 1 3 3 3 3 3 3 3 3 3 3 3 1 3 3 3 1
1 3 1 1 1 3 1 1 1 1 1 1 1 1 1 3 1 1 1 3 1
1 3 3 3 3 3 3 3 3 3 3 3 3 3 3 3 3 3 3 3 1
1 3 1 1 1 3 1 1 1 1 3 1 1 1 1 3 1 1 1 3 1
1 3 3 3 1 3 1 1 9 7 3 2 8 1 1 3 1 3 3 3 1
1 3 1 1 1 3 1 1 1 1 1 1 1 1 1 3 1 1 1 3 1
1 6 3 3 3 3 3 3 3 3 3 3 3 3 3 3 3 3 3 6 1
1 1 1 1 1 1 1 1 1 1 1 1 1 1 1 1 1 1 1 1 1