21 21
1 1 1 1 1 1 1 1 1 1 1 1 1 1 1 1 1 1 1 1 1
1 6 3 3 3 3 3 3 3 3 3 3 3 3 3 3 3 3 3 6 1
1 3 1 1 1 1 1 1 1 1 3 1 1 1 1 1 1 1 1 3 1
1 3 1 3 3 3 3 3 3 3 3 3 3 3 3 3 3 3 1 3 1
1 3 1 3 1 1 1 1 1 1 3 1 1 1 1 1 1 3 1 3 1
1 3 1 3 1 3 3 3 3 3 3 3 3 3 3 3 1 3 1 3 1
1 3 1 3 1 3 1 1 1 1 3 1 1 1 1 3 1 3 1 3 1
1 3 1 3 1 3 1 3 3 3 3 3 3 3 1 3 1 3 1 3 1
1 3 1 3 1 3 1 3 1 1 2 1 1 3 1 3 1 3 1 3 1
1 3 1 3 1 3 1 3 1 8 7 9 1 3 1 3 1 3 1 3 1
1 3 3 3 3 3 3 3 1 1 1 1 1 3 3 3 3 3 3 3 1
1 3 1 3 1 3 1 3 3 3 0 3 3 3 1 3 1 3 1 3 1
1 3 1 3 1 3 1 3 1 1 1 1 1 3 1 3 1 3 1 3 1
1 3 1 3 1 3 1 3 3 3 3 3 3 3 1 3 1 3 1 3 1
1 3 1 3 1 3 1 1 1 1 3 1 1 1 1 3 1 3 1 3 1
1 3 1 3 1 3 3 3 3 3 3 3 3 3 3 3 1 3 1 3 1
1 3 1 3 1 1 1 1 1 1 3 1 1 1 1 1 1 3 1 3 1
1 3 1 3 3 3 3 3 3 3 3 3 3 3 3 3 3 3 1 3 1
1 3 1 1 1 1 1 1 1 1 3 1 1 1 1 1 1 1 1 3 1
1 6 3 3 3 3 3 3 3 3 3 3 3 3 3 3 3 3 3 6 1
1 1 1 1 1 1 1 1 1 1 1 1 1 1 1 1 1 1 1 1 1