21 21
1 1 1 1 1 1 1 1 1 1 1 1 1 1 1 1 1 1 1 1 1
1 6 3 3 3 3 3 3 3 3 1 3 3 3 3 3 3 3 3 6 1
1 3 1 1 1 3 1 1 1 3 1 3 1 1 1 3 1 1 1 3 1
1 3 3 3 3 3 3 3 3 3 3 3 3 3 3 3 3 3 3 3 1
1 3 1 1 1 3 1 3 1 1 1 1 1 3 1 3 1 1 1 3 1
1 3 3 3 3 3 1 3 3 3 1 3 3 3 1 3 3 3 3 3 1
1 1 1 1 1 3 1 1 1 3 1 3 1 1 1 3 1 1 1 1 1
1 1 1 1 1 3 1 3 3 3 3 3 3 3 1 3 1 1 1 1 1
1 1 1 1 1 3 1 3 1 1 7 1 1 3 1 3 1 1 1 1 1
1 3 3 3 3 3 3 3 1 2 9 8 1 3 3 3 3 3 3 3 1
1 1 1 1 1 3 1 3 1 1 1 1 1 3 1 3 1 1 1 1 1
1 1 1 1 1 3 1 3 3 3 0 3 3 3 1 3 1 1 1 1 1
1 1 1 1 1 3 1 3 1 1 1 1 1 3 1 3 1 1 1 1 1
1 3 3 3 3 3 3 3 3 3 1 3 3 3 3 3 3 3 3 3 1
1 3 1 1 1 3 1 1 1 3 1 3 1 1 1 3 1 1 1 3 1
1 3 3 3 1 3 3 3 3 3 3 3 3 3 3 3 1 3 3 3 1
1 1 1 3 1 3 1 3 1 1 1 1 1 3 1 3 1 3 1 1 1
1 3 3 3 3 3 1 3 3 3 1 3 3 3 1 3 3 3 3 3 1
1 3 1 1 1 1 1 1 1 3 1 3 1 1 1 1 1 1 1 3 1
1 6 3 3 3 3 3 3 3 3 3 3 3 3 3 3 3 3 3 3 1
1 1 1 1 1 1 1 1 1 1 1 1 1 1 1 1 1 1 1 1 1